00000000000000000000
11111111111111111010
01000000000000000010
01011111111111111010
01010000000000001010
01010111111111001010
01010100000001001010
01010101111101001010
01010101000001001010
01010101111111001010
01010100000000001010
01010111111111001010
01010000001001001010
01011111111001001010
01000000001001001010
01111111111001001010
00000000001001001010
01111111111001001110
00000111111001100011
00000000000000000000